 \ 	 ~ 
\mathbin	None
\mathopen	None
\mathclose	None
\mathord	None
\mathinner	None
\mathpunct	None
\mathop	None
\mathrel	None
\mathstrut	None
\ensuremath	None
\displaystyle	None
\textstyle	None
\scriptstyle	None
\scriptscriptstyle	None
\limits	None
\nolimits	None
\bgroup	None
\egroup	None
\aftergroup	None
\begingroup	None
\endgroup	None
\,	~
\thinspace	~
\>	~
\:	~
\medspace	~
\;	~
\thickspace	~
\enspace	~
\space	~
\nobreakspace	~
\negthinspace	\!
\negmedspace	\!
\negthickspace	\!
\nonumber	None