--	- -
---	- - -
\Bar	\bar
\Breve	\breve
\Tilde	\tilde
\Ddot	\ddot
\Dot	\dot
\Hat	\hat
\Vec	\vec
\overbar	\bar
\slash	/
\/	/
⁄	/
\*	*
⊗	\otimes
×	\times
⋅	\cdot
°	\degree
±	\pm
≅	\cong
≤	\leq
…	\dots
\hdots	\cdots
\time	\times
\allowdisplaybreaks	None
–	-
\-	None
\medskip	None
\normalfont	None
\lefteqn	None
\textsc	\textrm
\displaylimits	None
\sp	^
\sb	_
\unboldmath	None
\upalpha	\alpha
\upbeta	\beta
\upgamma	\gamma
\updelta	\delta
\upepsilon	\epsilon
\upzeta	\zeta
\upeta	\eta
\uptheta	\theta
\upiota	\iota
\upkappa	\kappa
\uplambda	\lambda
\upmu	\mu
\upnu	\nu
\upxi	\xi
\upomicron	\omicron
\uppi	\pi
\uprho	\rho
\upsigma	\sigma
\uptau	\tau
\upupsilon	\upsilon
\upphi	\phi
\upchi	\chi
\uppsi	\psi
\upomega	\omega
\upvarepsilon	\varepsilon
\raisebox \{ \depth \}	None